++++++++++++++++++++++++++++
+      a                   +
+  0                       +
+       A                  + 
+                          +
+                          +
+                          +
+                        A +
++++++++++++++++++++++++++++