++++++++++++
+  A       +
+ A0A      +
+  A       + 
+        Aa+
++++++++++++