++++++++
+0     +
+   A  +
+      +
+    a +
++++++++
