red: 0,A
+++++++++++++++++++
+ A        0      +
+              ++++
+                 +
+              ++ +
+               +a+
+++++++++++++++++++
